000000000
000000000
000000000
000000000
000000000
222222222
333333333
333333333
333333333